00000000000000000010000000
00000000000000000000000000
00000000000000000000000000
00010000000000000000000000
00000001000001000000000000
00000000000000011000000000
00000000000000000000000000
00000000000000000000000000
00000000001100000000010000
00000000000000e00000010000
00000110000000000000000000
00000110000000000000000000
01000000000000000000000010
010000000000x0000000000100
00000000000000000000001000
00000000000010001100000000
00000000000010001000000000
00000000000000001100000000
00000000000000000000000000
00000000000000000000000000
00000011000000000000000000
00000000000000110000000000
